111111111111111111111111111111111111111111111111111111111111111111111
1E0000000000000C00000C00000000000000101010101101010101010101010100101
101001010010000010100100000001010100C00000000000000C00000000000000C01
101001001010101000100100000001010100C00000000000000C00000000000000C01
100000000C00C0000000000000000000C100C00000000000000C00000000000000C01
111111111111111111001111111111111110100101001000001010010000000101011
100000000000000000000000010100100101010100010010000000101010010111011
1000001010101010101010100001111111100000000C00C0000000000000000000C11
100000101010101010101010000111111111111111111111000000000011111111111
1C0000000000000C00000C00000000000110100101001000001010010000000101011
100000101010101010101010000111111110100100101010100010010000000101011
1000001010101010101010100001111110000000000C00C0000000000000000000C11
111111111111111111110000000000011110000010101010101010101000011111111
111111111000000111111111111111111110000010101010101010101000011101111
111111111111100011111111111111111110000010101010101010101000011111111
1C0000000000000C00000C00000000000110000010101010101010101000010000111
101001010010000010100100000001010000000010101010101010101000011111111
101001001010101000100100000001010110000010101010101010101000011100111
1P0000000C00C0000000000000000000C110000010101010101010101000011111111
111111111111111111111111111111111111111111111111111111111111111111111